11111
1CCC1
10001
1PCC1
1EFE1
101E1
1C001
10E11
10C11
11111