111111111111
1P0010EC1001
111FE10C0001
11EC0CEC1EC1
1E11C11EECE1
11111E1CCCE1
111111111111