11111111111111111111111111111111111
1110C0000C1C000001000C000001C0001E1
11101F11F01111110101111111C1C110101
111000C10C11111101C100C000011110101
111111110F1111110101011111110000101
1000C00000111111010101FC00F10110101
1C11110111111F0C0101C1FFF0F1011C101
101C110111111C010101011110110111101
1P1000C0000C00F100010000C0000000001
11111111111111111111111111111111111