1111111111111111111111111
1P00000C0000F00C000000001
10F01FFC100C001F000E00001
1111111111111111111111111