111111111111111111
100001001000001001
100000000000FF0001
10P000000CCCCCC001
1000000000000000E1
111111111111111111