111111111111111111111111111111
1EP0FC01E0CCC10C10C1C1CCC11C01
1CCECE1E00E1CCE1C1EC00CE010E11
1CCC110C1000E0C0E0C000EEC0CE01
11ECC01C0000CCE0E0ECC0EECCC1E1
10E00CEEEE001CCC0011CEE11C1C01
1CC1E00111EEE01EEEC11C0E01E0C1
1EEEC010C0CCC0C0CC0C0ECC0E0CE1
11EC1C0CE0E0E010ECC01EECCC1E01
100001E0C1E0CEE01ECE010011ECC1
1EC11E0C11EC1E1CCEECC0CECE1CE1
111CECC1CECCE01E11CCE000EE10C1
10E00EE1C0111CCE1CE1E0ECC110E1
11C000CC0CEEEEE1C0ECECCCE00C01
10E10C0EE101C1E01C0CE01EEC0E11
1C00E1C0CE1CE0C0CCEC111101E0C1
111CE01C0CE10EC001CEC00EC0EE01
1C1EC1C00C1E1EE0E0C100E1C1E101
1C1C110C0E1C0100E1EC00CEC0E001
111111111111111111111111111111